wwwwwwwwwwwwwwww
w......w....g..w
w......w.......w
w.....www......w
w..2...www.....w
w..wwwwwwwwww..w
w........w.....w
w........w.....w
w......w...2...w
wA.....w+...1..w
w......w.......w
wwwwwwwwwwwwwwww
